NO tex/Wall.png
SO tex/Wall.png
WE tex/Wall.png
EA tex/Wall.png

F 66,70,50
C 81,209,246

 11111111111111 
1000000000000001
10S0000000000001
1000000000000001
1000000000000001
1000000000000001
10000001000000011111111111111111111111111111111111111
1000001 1000000200000000000000000000000000000000000001
10000001000000011111111111111111111111111111111111111
1000000000000001
1000000000000001
1000000000000001
1000000000000001
1000000000000001
 11111111111111
