F                                                            66,70,50
C 81,209,255


NO                     tex/Wall.jpg
SO tex/Wall.png
WE tex/Wall.png
EA tex/Wall.png




      111111         11111
     10000001       1000001
     10011001       1000001       
     10000001       1000001
 111100000001       1000001        
100000000000011111110000001
100000000000020000000000001              1
10000000000001100001111111              101
1000001000001  1001                      1
 11111111111    11
 
         1

0




      111111         11111
     10000001       1000001
     10011001       100S001       
     10000001       1000001
 111100000001       1000001        
100000000000011111110000001
100000000000020000000000001              1
10000000000001100001111111              101
1000001000001  1001                      1
 11111111111    11
 
         1