NO textures/wall_1.png
SO textures/wall_2.png
WE textures/wall_2.png
EA textures/wall_1.png

F 66,70,50
C 81,209,246

111  11111111       1111111
101  10000001       1000001
101  10011001       100S001
101  10000001       1000001
1011110000001       1000001
100000000000111111111000001
100010001000000000000000001
100011111000111100111111111
1000000000001  1001        
1111111111111  1111        