NO                     textures/wall_1.png
SO textures/wall_2.png
WE textures/wall_2.png



EA textures/wall_1.png

F 66,70,50

C 81,209,246

     11111111       1111111
     10000001       1000001
     10011001       100S001
     10000001       1000001
1111110000001       1000001
100000000000111111111000001
100010101000000000000000001              1
100011 11100011110011111111             101
1000001000001  1001                      1
1111111111111  1111
