NO                     textures/wall_1.png
SO textures/wall_2.png
WE          		textures/wall_2.png



EA textures/wall_1.png

F 			66,70,50

C 81,209,246

      111111         11111
     10000001       1000001
     10011001       100E001
     10000001       1000001
 111100000001       1000001
100000000000011111110000001
100000100000000000000000001              1
100001 1000001100001111111              101
1000001000001  1001                      1
 11111111111    11
